C 77,5,11




NO ./textures/north.xpm 



SO ./textures/south.xpm


WE ./textures/west.xpm



EA ./textures/east.xpm

F 143,131,113


         111111111111111111111111
        1000000000110000000000001
        1011000001110000000000001
        1001000000000000000000001
111111111011000001110000000000001
100000000011000001110111111111111
11110111111111011100000010001000 
11110111111111011101010010001    
11000000110101011100000010001    
10000000000000001100000000001    
10000000000000001101010010W01    
1100000111010101110101101000111  
11110111 1110101 101111010001    
11111111 1111111 111111111111    